11 11 11 11 11 11 11 11 11 11 11 11 11 11 11 11 11 11 11 11 11 11 11 11 11 11 11 11 11 11 11 11 11 11 11 11 11 11 11 11 11 11 11 11 11 11 11 11 11 11 
11 11 11 11 11 11 11 11 11 11 11 11 11 11 12 11 11 11 11 11 11 11 11 11 11 11 11 11 11 11 11 11 11 11 11 11 11 11 11 11 11 11 11 11 11 11 11 11 11 11 
11 11 11 11 11 11 11 12 11 11 11 11 11 11 11 11 11 11 11 11 11 11 11 11 11 12 11 11 11 11 11 11 11 12 11 11 11 11 11 11 11 11 11 11 11 11 11 11 11 11 
11 11 11 11 12 11 11 11 11 11 11 12 11 11 11 11 11 11 12 11 11 11 11 11 11 11 11 12 11 11 11 11 11 11 11 11 11 11 11 11 11 12 11 11 11 11 11 11 11 11  
11 11 11 11 11 11 11 11 11 12 11 11 11 11 11 12 11 11 11 11 11 11 11 12 11 11 11 11 11 11 11 12 11 11 12 11 11 11 12 11 11 11 11 11 11 11 11 11 11 11 
11 11 11 11 11 11 11 11 11 11 11 11 11 11 11 11 11 11 11 11 11 12 11 11 11 11 11 11 11 12 11 11 11 11 11 11 12 11 11 11 11 11 11 12 11 11 11 11 11 11  
11 11 11 11 11 12 11 11 11 11 11 11 11 11 11 11 11 11 11 11 11 11 11 11 11 11 11 11 11 11 11 11 11 11 11 11 11 11 11 11 11 11 11 11 11 11 11 11 11 11 
11 11 11 11 11 11 11 13 40 40 40 40 40 13 11 11 11 11 11 13 12 12 11 12 12 12 12 11 11 11 11 11 13 12 12 12 12 12 12 12 12 12 11 11 11 12 11 11 11 11 
11 11 12 11 11 11 11 13 40 39 39 39 40 13 13 13 13 13 13 13 12 11 11 11 11 11 12 13 13 13 13 13 13 13 12 10 10 10 10 10 10 12 11 11 11 11 11 11 11 11
11 11 11 11 11 11 11 13 40 39 39 39 40 13 13 13 13 13 13 13 12 11 11 11 11 11 12 13 13 13 13 13 13 13 12 10 10 10 10 10 10 12 11 11 11 11 11 11 11 11
11 11 11 12 11 11 11 13 40 39 39 39 40 13 13 13 13 13 13 13 12 11 11 11 11 11 11 13 13 13 13 13 13 13 12 10 10 10 10 10 10 12 11 11 12 11 11 11 11 11
11 11 11 11 12 11 11 13 40 39 39 39 40 13 13 13 13 13 13 13 12 11 11 11 11 11 12 13 13 13 13 13 13 13 12 10 10 10 10 10 10 12 11 11 11 11 11 11 11 11
11 11 11 11 11 11 11 13 40 40 39 40 40 13 13 13 13 13 13 13 11 12 12 10 12 12 12 13 13 13 13 13 13 13 12 12 12 12 10 12 12 12 11 12 11 11 11 11 11 11
11 11 11 11 11 11 11 13 13 13 12 13 13 13 13 13 13 13 13 13 13 13 12 10 12 13 13 13 13 13 13 13 13 13 13 13 13 12 10 12 11 11 11 11 11 11 11 11 11 11
11 11 11 11 12 11 11 13 13 13 12 13 13 13 13 13 13 13 13 13 13 13 12 10 12 13 13 13 13 13 13 13 13 13 13 13 13 12 10 12 11 11 11 11 11 12 11 11 11 11
11 11 11 11 11 11 11 11 11 13 12 13 13 13 13 13 13 13 13 13 13 13 12 10 12 13 13 13 13 13 13 13 13 13 13 13 13 12 10 12 11 11 11 11 11 11 11 11 11 11
11 11 11 11 11 11 11 11 11 13 12 13 13 13 13 13 13 13 13 13 13 13 12 10 12 13 13 13 13 13 13 13 13 13 13 13 13 12 10 12 11 11 11 11 11 11 12 11 11 11
11 11 12 11 11 11 11 11 11 13 12 13 13 13 13 13 13 13 13 13 13 13 12 10 12 13 13 13 13 13 13 13 13 13 13 12 12 12 10 12 11 11 11 12 11 11 11 11 11 11
11 11 11 11 11 11 11 11 12 12 12 13 13 13 13 13 13 13 13 13 13 13 12 10 12 13 13 13 13 13 13 13 13 13 13 12 10 10 10 12 11 11 11 11 11 11 11 11 11 11
11 11 11 12 11 11 11 11 12 13 13 13 13 13 13 13 13 13 13 13 13 12 12 10 12 12 13 13 13 13 13 13 13 13 13 12 10 12 12 12 11 11 12 11 11 11 11 11 11 11
11 11 11 11 11 11 11 11 12 13 13 13 12 12 12 12 12 12 12 12 12 12 12 10 12 12 12 12 12 12 12 12 12 12 12 12 10 12 12 13 11 11 11 11 11 11 11 11 11 11
11 11 11 11 11 12 11 11 12 13 13 13 11 12 10 10 10 10 10 10 10 10 10 10 10 10 10 10 10 10 10 10 10 10 10 10 10 12 12 11 11 11 11 11 11 11 11 11 11 11
11 11 11 11 11 11 12 11 12 12 13 13 12 12 12 12 12 12 12 12 12 12 12 10 12 12 12 12 12 12 12 12 12 12 12 12 10 12 12 11 11 12 11 11 11 11 11 11 11 11
11 11 11 11 11 11 11 11 11 12 13 13 12 13 13 13 13 13 13 13 13 12 12 10 12 12 13 13 13 13 13 13 13 13 13 12 10 12 12 11 11 11 11 11 12 11 11 11 11 11
11 11 11 11 11 11 11 11 11 12 13 13 12 13 13 13 13 13 13 13 13 13 12 10 12 13 13 13 13 13 13 13 13 13 13 12 10 12 11 11 11 11 11 11 11 11 11 11 11 11
11 11 11 11 11 12 11 11 11 12 13 13 12 12 12 13 13 13 13 13 13 13 12 10 12 13 13 13 13 13 13 13 13 13 13 12 10 12 12 11 11 11 11 12 11 11 11 11 11 11
11 11 11 11 11 11 11 11 12 12 13 13 13 13 12 13 13 13 13 13 13 13 12 10 12 13 13 13 13 13 13 13 13 13 13 12 10 12 12 11 11 11 11 11 11 11 11 11 11 11
11 11 11 12 11 11 11 11 12 13 13 13 13 13 12 13 13 13 13 13 13 13 12 10 12 13 13 12 13 13 13 13 13 13 13 12 10 12 12 11 11 12 11 11 11 11 11 11 11 11
11 11 11 11 11 11 11 11 12 13 13 13 13 13 12 13 13 13 13 13 13 13 12 10 12 13 13 13 13 13 12 13 13 13 13 12 10 12 12 11 11 11 11 11 11 11 11 11 11 11
11 11 11 11 11 11 12 11 12 12 12 12 12 12 12 13 13 13 13 13 13 13 12 10 12 13 13 13 13 13 12 13 13 13 13 12 12 12 12 11 11 11 11 11 12 11 11 11 11 11
11 11 11 11 11 11 11 11 12 12 11 12 12 12 12 13 13 13 13 13 13 13 12 10 12 13 13 13 13 13 13 13 13 13 13 13 12 13 11 11 11 11 12 11 11 11 11 11 11 11
11 11 11 11 11 11 11 11 11 12 12 12 12 12 12 13 13 13 13 13 13 13 12 10 12 13 13 13 13 13 13 13 13 13 13 12 12 12 11 11 11 11 11 11 11 11 11 11 11 11
11 11 11 11 11 12 11 11 11 12 12 12 12 11 12 13 13 13 13 13 13 13 12 10 12 13 13 13 13 13 13 13 13 13 13 12 12 12 11 11 11 11 11 11 11 11 12 11 11 11
11 11 11 11 11 11 11 11 11 11 12 12 12 12 12 13 13 13 13 13 13 13 12 10 12 13 13 13 13 13 13 13 13 13 13 12 12 11 11 11 11 12 11 11 11 11 11 11 11 11
11 11 11 11 11 11 11 11 11 12 12 12 12 12 12 13 13 13 13 13 13 13 12 10 12 13 13 13 13 13 13 13 13 13 13 12 12 12 11 11 11 11 11 11 11 11 11 11 11 11
11 11 11 11 12 11 11 11 11 13 13 13 13 13 13 13 13 13 13 13 13 13 12 12 12 13 13 13 13 13 13 13 13 13 13 11 12 12 11 11 11 11 11 11 11 11 11 11 11 11 
11 11 11 11 11 11 11 11 13 13 13 13 13 13 13 13 13 13 13 12 12 12 12 12 12 12 12 13 13 13 13 13 13 13 12 12 12 12 12 11 11 11 11 11 12 11 11 11 11 11 
11 11 11 11 11 11 12 11 13 13 13 13 13 13 13 13 13 13 12 12 12 12 12 12 12 12 12 12 13 13 12 13 13 12 12 12 12 12 12 12 11 11 11 11 11 11 11 11 11 11 
11 11 11 11 11 11 11 11 12 13 13 13 13 13 13 13 13 13 12 11 12 12 12 12 12 11 12 12 13 13 13 13 12 12 12 12 12 11 12 12 11 11 12 11 11 11 11 11 11 11 
11 11 11 11 11 11 11 11 12 13 13 13 13 12 13 13 13 13 12 12 11 12 12 12 12 12 12 12 12 13 13 13 12 12 12 12 12 13 12 12 11 11 11 11 11 11 11 11 11 11 
11 11 12 11 11 11 11 11 12 13 13 13 13 13 13 13 13 13 12 12 12 12 12 12 12 12 12 12 12 12 12 12 12 12 13 12 12 12 12 12 11 11 11 11 11 12 11 11 11 11 
11 11 11 11 11 11 11 11 12 13 13 13 13 12 13 11 11 11 11 12 12 12 12 12 11 12 12 11 11 11 11 12 12 12 12 12 12 12 11 12 11 11 11 11 11 11 11 12 11 11 
11 11 11 11 11 11 11 11 13 13 13 13 13 13 11 11 11 11 11 11 12 12 12 12 12 12 11 11 11 11 11 12 12 13 12 12 13 12 12 12 11 11 11 11 11 11 11 11 11 11 
11 11 11 11 12 11 11 11 11 11 11 11 11 11 11 11 11 11 11 11 11 11 11 11 11 11 11 11 12 11 11 11 12 11 12 12 12 12 11 11 11 11 12 11 11 11 11 11 11 11 
11 11 11 11 11 11 11 11 11 11 11 11 11 11 11 11 11 11 12 11 11 11 11 11 11 11 11 11 11 11 11 11 11 11 11 11 11 11 11 11 11 11 11 11 11 11 12 11 11 11 
11 11 11 11 11 11 11 11 11 11 11 12 11 11 11 11 12 11 11 11 11 11 11 11 11 11 11 11 11 11 11 11 11 11 11 11 12 11 11 11 11 11 11 12 11 11 11 11 11 11 
11 11 11 11 11 11 12 11 11 11 11 11 11 11 11 11 11 11 11 11 11 11 11 11 12 11 11 11 11 12 11 11 11 11 11 11 11 11 11 11 11 11 11 11 11 11 11 11 11 11 
11 11 11 11 11 11 11 11 11 11 11 11 11 11 12 11 11 11 11 11 12 11 11 11 11 11 11 11 11 11 11 11 12 11 11 11 11 11 11 12 11 11 11 11 11 11 11 11 11 11 
11 11 11 11 11 11 11 11 11 11 11 11 11 11 11 11 11 11 11 11 11 11 11 11 11 11 11 12 11 11 11 11 11 11 11 11 11 11 11 11 11 11 11 11 11 12 11 11 11 11 
11 11 11 11 11 11 11 11 11 11 11 11 11 11 11 11 11 11 11 11 11 11 11 11 11 11 11 11 11 11 11 11 11 11 11 11 11 11 11 11 11 11 11 11 11 11 11 11 11 11 