11 11 11 11 11 11 11 11 11 11 11 11 11 11 11 11 11 11 11 11 11 11 11 11 11 11 11 11 11 11 11 11 11 11 11 11 11 11 11 11 11 11 11 11 11 11 11 11 11 11 
11 11 11 11 11 11 11 11 11 11 11 11 11 11 11 11 11 11 11 11 11 11 11 11 11 11 11 11 11 11 11 11 11 11 11 11 11 11 11 11 11 11 11 11 11 11 11 11 11 11 
11 11 11 11 11 11 11 11 11 11 11 11 11 11 11 11 11 11 11 11 10 10 10 10 10 10 10 11 11 11 11 11 11 11 11 11 11 11 11 11 11 11 11 11 11 11 11 11 11 11 
11 11 11 11 11 11 11 11 11 11 11 11 11 11 11 11 11 11 11 11 10 10 10 10 10 10 10 11 11 11 11 11 11 11 11 11 11 11 11 11 11 11 11 11 11 11 11 11 11 11 
11 11 11 11 11 11 11 11 11 11 11 11 11 11 11 11 11 11 11 11 12 10 10 10 10 10 10 11 11 11 11 11 11 11 11 11 11 11 11 11 11 11 11 11 11 11 11 11 11 11
11 11 11 11 11 11 11 11 11 11 11 11 11 11 11 11 11 11 11 11 10 12 10 10 12 12 10 11 11 11 11 11 11 11 11 11 11 11 11 11 11 11 11 11 11 11 11 11 11 11
11 11 11 11 11 11 11 11 40 40 40 40 40 11 11 11 11 11 11 11 11 10 10 10 10 10 11 11 11 11 11 11 11 11 11 11 11 11 11 11 11 11 11 11 11 11 11 11 11 11 
11 11 11 11 11 11 11 11 40 39 39 39 40 11 11 11 11 11 11 11 10 10 10 10 10 10 10 11 11 11 11 11 11 10 10 10 10 12 10 10 10 11 11 11 11 11 11 11 11 11
11 11 11 11 11 11 11 11 40 39 39 39 40 11 11 11 11 11 11 11 11 10 10 10 10 10 11 11 11 11 11 11 11 11 10 10 10 10 10 12 10 10 11 11 11 11 11 11 11 11
11 11 11 11 11 11 11 11 40 39 39 39 40 11 11 11 11 11 11 11 11 11 10 10 10 11 11 11 11 11 11 11 11 11 10 12 10 10 10 10 12 10 11 11 11 11 11 11 11 11
11 11 11 11 11 11 11 11 40 39 39 39 40 11 11 11 11 11 11 11 11 11 10 12 10 11 11 11 11 11 11 11 11 11 10 12 12 12 10 10 10 10 11 11 11 11 11 11 11 11
11 11 11 11 11 11 11 11 40 40 10 40 40 11 11 11 11 11 11 11 11 11 10 12 10 11 11 11 11 11 11 11 11 11 10 10 10 15 10 10 10 10 11 11 11 11 11 11 11 11
11 11 11 11 11 11 11 11 11 10 10 10 11 11 11 11 11 11 11 11 11 11 10 10 12 11 11 11 11 11 11 11 11 11 11 10 10 10 10 10 10 11 11 11 11 11 11 11 11 11
11 11 11 11 11 11 11 11 11 10 10 10 11 11 11 11 11 11 11 11 11 11 10 10 12 11 11 11 11 11 11 11 11 11 11 11 11 10 10 10 11 11 11 11 11 11 11 11 11 11
11 11 11 11 11 11 11 11 11 10 10 10 11 11 11 11 11 11 11 11 11 11 10 10 10 11 11 11 11 11 11 11 11 11 11 11 11 10 10 10 11 11 11 11 11 11 11 11 11 11
11 11 11 11 11 11 11 11 14 10 10 10 11 11 11 11 11 11 11 11 11 11 10 10 12 11 11 11 11 11 11 11 11 11 11 11 11 10 10 10 11 11 11 11 11 11 11 11 11 11
11 11 11 11 11 11 11 10 10 10 15 10 11 11 11 11 11 11 11 11 11 11 10 12 10 11 11 11 11 11 11 11 11 11 11 11 11 10 10 10 11 11 11 11 11 11 11 11 11 11
11 11 11 11 11 11 11 10 15 10 10 10 11 11 11 11 11 11 11 11 11 11 10 10 10 11 11 11 11 11 11 11 11 11 11 11 10 10 10 10 11 11 11 11 11 11 11 11 11 11
11 11 11 11 11 11 11 10 10 10 11 11 11 11 11 11 11 11 11 11 11 11 10 10 10 11 11 11 11 11 11 11 11 11 11 14 10 10 10 10 11 11 11 11 11 11 11 11 11 11
11 11 11 11 11 11 11 10 10 10 11 11 11 11 11 11 11 11 11 11 11 14 10 10 10 15 11 11 11 11 11 11 11 11 11 10 10 10 10 11 11 11 11 11 11 11 11 11 11 11
11 11 11 11 11 11 11 10 10 10 11 14 10 10 12 12 12 10 10 10 10 10 10 10 10 10 10 10 10 10 10 10 10 15 10 10 10 10 11 11 11 11 11 11 11 11 11 11 11 11
11 11 11 11 11 11 11 10 10 10 11 10 10 10 15 10 10 10 10 10 10 10 10 15 10 10 10 15 10 10 10 15 10 10 10 10 10 10 11 11 11 11 11 11 11 11 11 11 11 11
11 11 11 11 11 11 11 13 10 13 11 10 10 10 10 10 10 10 10 10 10 10 10 10 10 10 10 10 10 10 10 10 10 10 10 10 12 10 11 11 11 11 11 11 11 11 11 11 11 11
11 11 11 11 11 11 11 10 10 10 11 13 10 13 11 11 11 11 11 11 11 10 10 10 10 10 11 11 11 11 11 11 11 11 11 10 12 10 11 11 11 11 11 11 11 11 11 11 11 11
11 11 11 11 11 11 11 10 10 10 11 10 10 10 10 10 11 11 11 11 11 11 10 12 10 11 11 11 11 11 11 11 11 11 11 10 12 10 11 11 11 11 11 11 11 11 11 11 11 11
11 11 11 11 11 11 11 10 10 10 11 10 10 10 10 10 11 11 11 11 11 11 10 10 12 11 11 11 11 11 11 11 11 11 11 10 10 10 11 11 11 11 11 11 11 11 11 11 11 11
11 11 11 11 11 11 11 10 10 10 11 10 10 10 10 10 11 11 11 11 11 11 10 10 10 11 11 11 11 11 11 11 11 11 11 10 10 10 11 11 11 11 11 11 11 11 11 11 11 11
11 11 11 11 11 11 11 10 10 10 11 11 11 10 10 10 11 11 11 11 11 11 12 10 10 11 11 10 11 11 11 11 11 11 11 10 12 10 11 11 11 11 11 11 11 11 11 11 11 11
11 11 11 11 11 11 11 10 12 12 11 11 11 10 10 10 11 11 11 11 11 11 12 12 10 11 11 11 11 11 10 11 11 11 11 10 12 10 11 11 11 11 11 11 11 11 11 11 11 11
11 11 11 11 11 11 11 10 10 12 12 12 12 12 10 10 11 11 11 11 11 11 10 12 10 11 11 11 11 11 10 11 11 11 11 10 12 10 11 11 11 11 11 11 11 11 11 11 11 11
11 11 11 11 11 11 11 12 10 12 15 12 10 10 10 10 11 11 11 11 11 11 10 10 10 11 11 11 11 11 11 11 11 11 11 10 12 10 11 11 11 11 11 11 11 11 11 11 11 11
11 11 11 11 11 11 11 10 10 12 12 12 12 10 12 12 11 11 11 11 11 11 10 10 10 11 11 11 11 11 11 11 11 11 11 10 12 10 11 11 11 11 11 11 11 11 11 11 11 11
11 11 11 11 11 11 11 10 14 10 15 10 12 10 10 11 11 11 11 11 11 11 10 12 10 11 11 11 11 11 11 11 11 11 11 12 10 10 11 11 11 11 11 11 11 11 11 11 11 11
11 11 11 11 11 11 11 12 12 10 12 12 10 10 12 11 11 11 11 11 11 11 10 12 10 11 11 11 11 11 11 11 11 11 11 12 10 10 11 11 11 11 11 11 11 11 11 11 11 11
11 11 11 11 11 11 11 10 10 10 10 10 10 12 10 11 11 11 11 11 11 11 10 10 10 11 11 11 11 11 11 11 11 11 11 10 10 10 11 11 11 11 11 11 11 11 11 11 11 11
11 11 11 11 11 11 11 11 11 11 11 11 11 11 11 11 11 11 11 11 11 11 10 10 10 11 11 11 11 11 11 11 11 11 11 10 10 10 11 11 11 11 11 11 11 11 11 11 11 11
11 11 11 11 11 11 11 11 11 11 11 11 11 11 11 11 11 11 11 10 10 10 10 10 10 10 10 11 11 11 11 11 11 11 10 10 10 10 10 11 11 11 11 11 11 11 11 11 11 11 
11 11 11 11 11 11 11 11 11 11 11 11 11 11 11 11 11 11 10 10 14 10 10 10 10 10 10 10 11 11 10 11 11 10 12 10 10 10 10 11 11 11 11 11 11 11 11 11 11 11
11 11 11 11 11 11 11 11 11 11 11 11 11 11 11 11 11 11 10 10 10 10 12 10 10 12 10 10 11 11 11 11 10 10 10 10 10 10 10 11 11 11 11 11 11 11 11 11 11 11
11 11 11 11 11 11 11 11 11 11 11 11 11 10 11 11 11 11 10 12 10 10 10 10 10 12 10 10 10 10 10 10 10 15 10 10 10 11 10 11 11 11 11 11 11 11 11 11 11 11
11 11 11 11 11 11 11 11 11 11 11 11 11 11 11 11 11 11 10 10 10 10 10 10 10 10 10 10 10 10 10 10 10 10 11 10 10 10 10 11 11 11 11 11 11 11 11 11 11 11 
11 11 11 11 11 11 11 11 11 11 11 11 11 10 11 11 11 11 11 10 10 10 12 10 10 10 10 11 11 11 11 10 10 10 10 14 14 10 10 11 11 11 11 11 11 11 11 11 11 11
11 11 11 11 11 11 11 11 11 11 11 11 11 11 11 11 11 11 11 11 10 10 10 10 10 10 11 11 11 11 11 10 10 11 10 14 11 10 10 11 11 11 11 11 11 11 11 11 11 11
11 11 11 11 11 11 11 11 11 11 11 11 11 11 11 11 11 11 11 11 11 11 11 11 11 11 11 11 11 11 11 11 10 10 10 10 10 10 11 11 11 11 11 11 11 11 11 11 11 11 
11 11 11 11 11 11 11 11 11 11 11 11 11 11 11 11 11 11 11 11 11 11 11 11 11 11 11 11 11 11 11 11 11 11 11 11 11 11 11 11 11 11 11 11 11 11 11 11 11 11 
11 11 11 11 11 11 11 11 11 11 11 11 11 11 11 11 11 11 11 11 11 11 11 11 11 11 11 11 11 11 11 11 11 11 11 11 11 11 11 11 11 11 11 11 11 11 11 11 11 11 
11 11 11 11 11 11 11 11 11 11 11 11 11 11 11 11 11 11 11 11 11 11 11 11 11 11 11 11 11 11 11 11 11 11 11 11 11 11 11 11 11 11 11 11 11 11 11 11 11 11 
11 11 11 11 11 11 11 11 11 11 11 11 11 11 11 11 11 11 11 11 11 11 11 11 11 11 11 11 11 11 11 11 11 11 11 11 11 11 11 11 11 11 11 11 11 11 11 11 11 11 
11 11 11 11 11 11 11 11 11 11 11 11 11 11 11 11 11 11 11 11 11 11 11 11 11 11 11 11 11 11 11 11 11 11 11 11 11 11 11 11 11 11 11 11 11 11 11 11 11 11 
11 11 11 11 11 11 11 11 11 11 11 11 11 11 11 11 11 11 11 11 11 11 11 11 11 11 11 11 11 11 11 11 11 11 11 11 11 11 11 11 11 11 11 11 11 11 11 11 11 11 